..................OOOOOOOOOOOOOOOOOOOOOOOOOOOOOOOOOOOOOOOOOOOOOOOOOOOOOOOOOOOO...................................................OOOOOOOOOOOOOOOOOOOOOO.....................///////////////////#
..................OOOOOOOOOOOOOOOOOOOOOOOOOOOOOOOOOOOOOOOOOOOOOOOOOOOOOOOOOOOO........................................................................O.....................///////////////////#
..................OOOOOOO........................................................................B.........................B..........................O.....................///////////////////#
..................OOOOO...................B................B...........B....B................OOOOOOOOO..................OOOOOOOO....B.................O................B....///////////////////#
..................OOOOO................OOOOOO....B........OOO....OOOOOOOOOOOOO......B...........................B..............OOOOOOOO..oOOOOOOOOOOOOO..........B..........///////////////////#
..................O.............B..........OOOOOOOOO......OOO....OOOOOOOOOOOOO...OOOOOOOO........B.........OOOOOOOOO..................O.......................OOOOOO........///////////////////#
.......OOOOOOOOOOOO...........OOOOO.......................OOO...............OO...............OOOOOOOOO.............OOOOOOOOO..........O.............B.......................///////////////////#
..........B....B.......OOOOOOOOOOOO.......................OOO...............OO........................................................O........OOOOOOOOOOOOO................///////////////////#
################################################################################################################################################################################################
