.........................................................................................................................................................................OOOOOOOOOOOOOOOOOOOOOOOOOOOO............///////////////////#
...........................................................................................................................................................B.............OOOOOOOOOOOOOOOOOOOOOOOOOOOO............///////////////////#
..........................................................B....B...B....B....B.............................................B.....................B........OOO..................................................B.///////////////////#
...............................................B........OOOOOOOOOOOOOOOOOOOOOOOOOO..................B....................OOOOOOO..............OOOOOOO.................B..........B....B....B.....B.....B.........///////////////////#
............................................OOOOOOO.....OOOOOOOOOOOOOOOOOOOOOOOOOOOOOOOO.......OOOOOOOOOO........B....................B.................O......O....OOOOOO......OOOOOOOOOOOOOOOOOOOOOOOOOOOOO....///////////////////#
...........................B.......OOOOO.......................................................OOOOOOOOOO......OOOOOOO.............OOOOOOO..............O......O.......OOO......OOOOOOOOOOOOOOOOOOOOOOOOOOOOO....///////////////////#
...............OOOO......OOOOOO.................................B.......B..........OOOOOOOOOOOOO........O................OOOOOOO.....................OOOO......O.......OOO...................B...................///////////////////#
......OOOO..............OOOOOOOO..............B.........OOOOOOOOOOOOOOOOOOOOOOOOOOOOOOOOOOOOOOOO........O.........................................OOOOOOOOOOOOOO.......OOO...........B...............B...........///////////////////#
#####################################################################################################################################################################################################################################
