........................................................................................................................O.......................................///////////////////#
........................................................................................................................O.......................................///////////////////#
.................................OOOOO..............................................B...................................O....................B..................///////////////////#
...........................OO....OOOOOOOOO......................................OOOOOOOOO.........................B.....O.......................................///////////////////#
...................OO......OO....OOOOOOOOOOOOO....B.....................OO.........OOO................OOOO.....OOOOO........OOOOOOOOOOOOOOO.....................///////////////////#
...................OO......OO................OOOOOOOOOO..........B......OO.........OOO......B.....OOOOOOOO.......O..........O......OO...........................///////////////////#
..........OOOOO....OO......OO............B.....................OOOOOOOOOOO.........OOOOOOOOOOOOOOOOOOOOOOO.......OOO....B...O......OO...........................///////////////////#
......OOOOO...O....OO......OO....OOOOOOOOOOOOO.............OOOOOO.......OO.......................OOOOOOOOO.......OOO...............OO...........................///////////////////#
####################################################################################################################################################################################
